100
100


3

0 .
1 #
2 o

##################################################
#................................................#
#................................................#
#................................................#
#................................................#
#................................................#
#................................................#
#................................................#
#................................................#
#................................................#
#................................................#
#................................................#
#................................................#
#.............##################.................#
#.............#................#.................#
#.............#................#oooooo...........#
#.............#................#.....o...........#
#....................................o...........#
#....................................o...........#
#.............#................#.....o...........#
#.............#................#oooooo...........#
#.............#................#.................#
#.............##################.................#
#................................................#
#................................................#
#................................................#
#................................................#
#................................................#
#................................................#
#................................................#
#................................................#
#................................................#
#................................................#
#................................................#
#................................................#
#................................................#
#................................................#
#................................................#
#................................................#
#................................................#
#................................................#
#................................................#
#................................................#
#................................................#
#................................................#
#................................................#
#................................................#
#................................................#
#................................................#
##################################################
